Евгений Владимирович Лебедев - мужской - Марина Викторовна Лебедева
Мария Андреевна Ковалева - женский - Нина Игоревна Ковалева
Мария Андреевна Ковалева - женский - Нина Игоревна Ковалева
Мария Андреевна Ковалева - женский - Нина Игоревна Ковалева
Андрей Игоревич Попов - мужской - Анастасия Александровна Попова
Оксана Сергеевна Петрова - женский - Екатерина Ивановна Петрова
Иван Васильевич Федоров - мужской - Наталья Александровна Федорова
Анастасия Владимировна Смирнова - женский - Ирина Андреевна Смирнова
Александр Анатольевич Кузнецов - мужской - Ольга Владимировна Кузнецова
Светлана Викторовна Новикова - женский - Татьяна Петровна Новикова
Игорь Александрович Иванов - мужской - Марина Игоревна Иванова
Наталья Ивановна Козлова - женский - Людмила Андреевна Козлова
Дмитрий Васильевич Попов - мужской - Анна Александровна Попова
Анастасия Ивановна Соколова - женский - Ольга Викторовна Соколова
Виктор Владимирович Новиков - мужской - Елена Сергеевна Новикова
Анна Сергеевна Иванова - женский - Лариса Петровна Иванова
Алексей Васильевич Федоров - мужской - Елена Игоревна Федорова
Елена Васильевна Петрова - женский - Нина Ивановна Петрова
Владимир Андреевич Кузнецов - мужской - Татьяна Викторовна Кузнецова
Нина Владимировна Попова - женский - Любовь Сергеевна Попова
Иван Петрович Смирнов - мужской - Анна Александровна Смирнова
Анна Александровна Ковалева - женский - Евгения Игоревна Ковалева
Ольга Сергеевна Кузнецова - женский - Ирина Владимировна Кузнецова
Алексей Иванович Иванов - мужской - Елена Викторовна Иванова
Екатерина Владимировна Новикова - женский - Наталья Андреевна Новикова
Александр Александрович Козлов - мужской - Мария Александровна Козлова
Ирина Андреевна Попова - женский - Нина Владимировна Попова
Владислав Иванович Соколов - мужской - Екатерина Игоревна Соколова
Татьяна Сергеевна Федорова - женский - Елена Александровна Федорова
Артем Александрович Иванов - мужской - Марина Игоревна Иванова
Юлия Викторовна Ковалева - женский - Оксана Сергеевна Ковалева
Сергей Иванович Петров - мужской - Наталья Владимировна Петрова
Нина Андреевна Кузнецова - женский - Екатерина Александровна Кузнецова
Андрей Александрович Смирнов - мужской - Татьяна Владимировна Смирнова
Марина Васильевна Новикова - женский - Анастасия Андреевна Новикова
Игорь Владимирович Козлов - мужской - Ольга Васильевна Козлова
Елена Игоревна Попова - женский - Марина Викторовна Попова
Алексей Андреевич Соколов - мужской - Нина Александровна Соколова
Мария Ивановна Федорова - женский - Анастасия Владимировна Федорова
Владимир Васильевич Иванов - мужской - Екатерина Сергеевна Иванова
Ольга Викторовна Ковалева - женский - Любовь Андреевна Ковалева
Денис Владимирович Петров - мужской - Нина Андреевна Петрова
Иван Андреевич Иванов - мужской - Наталья Игоревна Иванова
Анна Владимировна Новикова - женский - Елена Андреевна Новикова
Владислав Васильевич Козлов - мужской - Екатерина Сергеевна Козлова
Алина Александровна Попова - женский - Ольга Ивановна Попова
Алексей Викторович Соколов - мужской - Екатерина Сергеевна Соколова
Ирина Васильевна Федорова - женский - Наталья Сергеевна Федорова
Михаил Игоревич Иванов - мужской - Оксана Викторовна Иванова
Ангелина Александровна Ковалева - женский - Мария Сергеевна Ковалева
Петр Сергеевич Петров - мужской - Людмила Андреевна Петрова
Валерия Владимировна Кузнецова - женский - Ирина Андреевна Кузнецова
Артем Андреевич Смирнов - мужской - Анастасия Васильевна Смирнова
Надежда Васильевна Новикова - женский - Екатерина Александровна Новикова
Андрей Игоревич Козлов - мужской - Ольга Александровна Козлова
Екатерина Васильевна Попова - женский - Наталья Владимировна Попова
Даниил Александрович Соколов - мужской - Мария Сергеевна Соколова
Марина Александровна Федорова - женский - Ольга Ивановна Федорова
Сергей Васильевич Иванов - мужской - Анна Александровна Иванова
Евгения Игоревна Ковалева - женский - Татьяна Владимировна Ковалева
Дмитрий Сергеевич Петров - мужской - Елена Владимировна Петрова
Екатерина Александровна Кузнецова - женский - Оксана Андреевна Кузнецова
Марина Владимировна Смирнова - женский - Екатерина Александровна Смирнова
Артём Игоревич Кузнецов - мужской - Ольга Владимировна Кузнецова
Елизавета Сергеевна Соколова - женский - Наталья Петровна Соколова
Иван Фёдорович Иванов - мужской - Елена Михайловна Иванова
Анастасия Александровна Крылова - женский - Татьяна Ивановна Крылова
Сергей Андреевич Попов - мужской - Людмила Владимировна Попова
Дарья Дмитриевна Новикова - женский - Марина Игоревна Новикова
Максим Владимирович Морозов - мужской - Екатерина Александровна Морозова
Алиса Ивановна Кузьмина - женский - Ольга Викторовна Кузьмина
Илья Сергеевич Куликов - мужской - Анна Васильевна Куликова
Анна Андреевна Николаева - женский - Татьяна Владимировна Николаева
Андрей Павлович Жуков - мужской - Ирина Викторовна Жукова
Екатерина Андреевна Смирнова - женский - Ольга Владимировна Смирнова
Михаил Фёдорович Волков - мужской - Елена Сергеевна Волкова
Алина Игоревна Дмитриева - женский - Екатерина Васильевна Дмитриева
Денис Владимирович Ковалёв - мужской - Мария Петровна Ковалёва
Александра Сергеевна Новикова - женский - Наталья Ивановна Новикова
Владимир Александрович Соколов - мужской - Ольга Викторовна Соколова
Кристина Петровна Крылова - женский - Елена Викторовна Крылова
Екатерина Николаевна Андреева - женский - Татьяна Викторовна Андреева
Виктория Сергеевна Белова - женский - Надежда Александровна Белова
Владислава Павловна Бурова - женский - Ольга Анатольевна Бурова
Леонид Андреевич Волков - мужской - Светлана Ивановна Волкова
Антонина Александровна Герасимова - женский - Екатерина Михайловна Герасимова
Михаил Иванович Гришин - мужской - Елена Сергеевна Гришина
Ольга Денисовна Данилова - женский - Евгения Александровна Данилова
Наталья Александровна Ефимова - женский - Ирина Михайловна Ефимова
Сергей Дмитриевич Зайцев - мужской - Тамара Ивановна Зайцева
Евгений Викторович Козлов - мужской - Ирина Николаевна Козлова
Лилия Сергеевна Кузнецова - женский - Елена Владимировна Кузнецова
Никита Андреевич Лебедев - мужской - Ольга Владимировна Лебедева
Василий Петрович Макаров - мужской - Евгения Алексеевна Макарова
Алиса Дмитриевна Маркова - женский - Ирина Владимировна Маркова
Иван Александрович Николаев - мужской - Наталья Ивановна Николаева
Татьяна Валерьевна Орлова - женский - Екатерина Александровна Орлова
Антон Игоревич Павлов - мужской - Нина Анатольевна Павлова
Александра Валерьевна Петрова - женский - Ольга Владимировна Петрова
Александра Викторовна Андреева - женский - Ирина Михайловна Андреева
Иван Михайлович Смирнов - мужской - Мария Владимировна Смирнова
Ольга Алексеевна Попова - женский - Елена Александровна Попова
Андрей Игоревич Кузнецов - мужской - Екатерина Владимировна Кузнецова
Екатерина Анатольевна Федорова - женский - Татьяна Васильевна Федорова
Дмитрий Сергеевич Морозов - мужской - Надежда Ивановна Морозова
Анна Владимировна Новикова - женский - Тамара Васильевна Новикова
Сергей Александрович Волков - мужской - Ольга Васильевна Волкова
Татьяна Васильевна Андреева - женский - Людмила Викторовна Андреева
Владимир Иванович Петров - мужской - Нина Васильевна Петрова
Елена Игоревна Соколова - женский - Надежда Викторовна Соколова
Николай Павлович Ковалев - мужской - Любовь Васильевна Ковалева
Марина Владимировна Лебедева - женский - Екатерина Викторовна Лебедева
Алексей Андреевич Семенов - мужской - Александра Владимировна Семенова
Ирина Дмитриевна Егорова - женский - Ольга Васильевна Егорова
Виктория Сергеевна Павлова - женский - Наталья Ивановна Павлова
Роман Александрович Васильев - мужской - Галина Анатольевна Васильева
Никита Сергеевич Смирнов - мужской - Екатерина Михайловна Смирнова
Ольга Павловна Иванова - женский - Мария Ивановна Павлова
Александр Дмитриевич Кузнецов - мужской - Елена Александровна Кузнецова
Ирина Андреевна Соколова - женский - Нина Михайловна Соколова
Дмитрий Владимирович Попов - мужской - Мария Петровна Попова
Елена Михайловна Лебедева - женский - Анна Александровна Лебедева
Андрей Александрович Козлов - мужской - Татьяна Ивановна Козлова
Ольга Владимировна Новикова - женский - Людмила Александровна Новикова
Максим Алексеевич Морозов - мужской - Галина Ивановна Морозова
Екатерина Ивановна Петрова - женский - Наталья Сергеевна Петрова
Алексей Анатольевич Волков - мужской - Татьяна Владимировна Волкова
Юлия Андреевна Соловьева - женский - Лариса Владимировна Соловьева
Сергей Викторович Васильев - мужской - Ольга Сергеевна Васильева
Надежда Александровна Зайцева - женский - Елена Васильевна Зайцева
Антон Игоревич Павлов - мужской - Наталья Александровна Павлова
Татьяна Сергеевна Семенова - женский - Екатерина Николаевна Семенова
Александр Анатольевич Григорьев - мужской - Оксана Сергеевна Григорьева
Ирина Дмитриевна Богданова - женский - Елена Михайловна Богданова
Екатерина Ивановна Кузнецова - женский - Анна Александровна Кузнецова
Андрей Александрович Попов - мужской - Людмила Михайловна Попова
Ольга Сергеевна Ковалева - женский - Татьяна Ивановна Ковалева
Владислав Николаевич Смирнов - мужской - Надежда Петровна Смирнова
Надежда Владимировна Иванова - женский - Галина Петровна Иванова
Максим Игоревич Соколов - мужской - Наталья Васильевна Соколова
Ирина Александровна Кузьмина - женский - Елена Викторовна Кузьмина
Артем Сергеевич Медведев - мужской - Оксана Владимировна Медведева
Людмила Васильевна Лебедева - женский - Ирина Петровна Лебедева
Денис Иванович Николаев - мужской - Ольга Викторовна Николаева
Мария Степановна Волкова - женский - Нина Александровна Волкова
Антон Андреевич Кузьмин - мужской - Светлана Анатольевна Кузьмина
Екатерина Владимировна Сидорова - женский - Людмила Игоревна Сидорова
Роман Иванович Петров - мужской - Ольга Васильевна Петрова
Ирина Дмитриевна Федорова - женский - Татьяна Алексеевна Федорова
Владислав Анатольевич Комаров - мужской - Елена Владимировна Комарова
Оксана Ивановна Кузнецова - женский - Наталья Петровна Кузнецова
Сергей Игоревич Белов - мужской - Нина Викторовна Белова
Анастасия Александровна Соловьева - женский - Мария Ивановна Соловьева
Ксения Дмитриевна Ковалева - женский - Ольга Сергеевна Ковалева
Владимир Игоревич Белов - мужской - Надежда Владимировна Белова
Нина Александровна Смирнова - женский - Мария Николаевна Смирнова
Артем Сергеевич Кузнецов - мужской - Елена Викторовна Кузнецова
Дарья Александровна Попова - женский - Евгения Михайловна Попова
Андрей Владимирович Михайлов - мужской - Татьяна Владимировна Михайлова
Марина Александровна Соловьева - женский - Ирина Викторовна Соловьева
Игорь Александрович Новиков - мужской - Вера Ивановна Новикова
Елена Дмитриевна Петрова - женский - Любовь Николаевна Петрова
Константин Ильич Андреев - мужской - Алла Игоревна Андреева
Ольга Владимировна Лебедева - женский - Екатерина Александровна Лебедева
Валентина Петровна Егорова - женский - Зинаида Ивановна Егорова