Елена Дмитриевна Иванова - женский - Ольга Владимировна Иванова
Игорь Александрович Смирнов - мужской - Наталья Сергеевна Смирнова
Анна Владимировна Петрова - женский - Елена Ивановна Петрова
Сергей Васильевич Кузнецов - мужской - Евгения Ивановна Кузнецова
Надежда Ивановна Морозова - женский - Анна Александровна Морозова
Петр Николаевич Васильев - мужской - Мария Александровна Васильева
Татьяна Сергеевна Ковалева - женский - Оксана Владимировна Ковалева
Илья Павлович Новиков - мужской - Людмила Викторовна Новикова
Екатерина Александровна Соколова - женский - Ирина Валерьевна Соколова
Андрей Викторович Козлов - мужской - Татьяна Сергеевна Козлова
Ольга Васильевна Федорова - женский - Елена Александровна Федорова
Дмитрий Сергеевич Ильин - мужской - Евгения Петровна Ильина
Анастасия Андреевна Смирнова - женский - Лариса Сергеевна Смирнова
Владимир Владимирович Петров - мужской - Оксана Владимировна Петрова
Алина Сергеевна Кузнецова - женский - Татьяна Александровна Кузнецова
Георгий Иванович Морозов - мужской - Елена Викторовна Морозова
Елена Дмитриевна Васильева - женский - Нина Николаевна Васильева
Иван Владимирович Ковалев - мужской - Надежда Андреевна Ковалева
Александра Павловна Новикова - женский - Ольга Викторовна Новикова
Максим Александрович Соколов - мужской - Алла Владимировна Соколова
Артем Сергеевич Федоров - мужской - Ирина Анатольевна Федорова
Анастасия Дмитриевна Иванова - женский - Марина Викторовна Иванова
Денис Андреевич Смирнов - мужской - Лидия Петровна Смирнова
Софья Владимировна Петрова - женский - Евгения Викторовна Петрова
Владислав Васильевич Кузнецов - мужской - Анна Ивановна Кузнецова
Людмила Ивановна Морозова - женский - Евгения Владимировна Морозова
Николай Николаевич Васильев - мужской - Наталья Степановна Васильева
Анастасия Сергеевна Ковалева - женский - Наталья Николаевна Ковалева
Дмитрий Викторович Новиков - мужской - Елена Сергеевна Новикова
Александра Александровна Соколова - женский - Ирина Николаевна Соколова
Илья Петрович Козлов - мужской - Мария Александровна Козлова
Елизавета Сергеевна Федорова - женский - Людмила Ивановна Федорова
Андрей Дмитриевич Иванов - мужской - Марина Ивановна Иванова
Мария Андреевна Смирнова - женский - Анна Андреевна Смирнова
Сергей Викторович Петров - мужской - Нина Александровна Петрова
Екатерина Николаевна Кузнецова - женский - Елена Петровна Кузнецова
Игорь Иванович Морозов - мужской - Елена Анатольевна Морозова
Наталья Дмитриевна Васильева - женский - Оксана Павловна Васильева
Павел Александрович Ковалев - мужской - Ирина Петровна Ковалева
Екатерина Павловна Новикова - женский - Татьяна Владимировна Новикова
Владислав Андреевич Соколов - мужской - Наталья Игоревна Соколова
Александра Дмитриевна Козлова - женский - Елена Андреевна Козлова
Максим Сергеевич Федоров - мужской - Татьяна Александровна Федорова
Анна Андреевна Иванова - женский - Екатерина Владимировна Иванова
Георгий Петрович Смирнов - мужской - Марина Сергеевна Смирнова
Марина Владимировна Петрова - женский - Александра Александровна Петрова
Иван Анатольевич Кузнецов - мужской - Наталья Михайловна Кузнецова
Надежда Ивановна Морозова - женский - Евгения Петровна Морозова
Дмитрий Николаевич Васильев - мужской - Анастасия Сергеевна Васильева
Анна Сергеевна Ковалева - женский - Татьяна Викторовна Ковалева
Андрей Викторович Новиков - мужской - Нина Александровна Новикова
Екатерина Александровна Соколова - женский - Елена Владимировна Соколова
Степан Александрович Козлов - мужской - Анна Анатольевна Козлова
Екатерина Владимировна Федорова - женский - Ирина Николаевна Федорова
Алексей Андреевич Иванов - мужской - Лариса Викторовна Иванова
Мария Викторовна Смирнова - женский - Елена Васильевна Смирнова
Сергей Петрович Петров - мужской - Татьяна Анатольевна Петрова
Дарья Николаевна Кузнецова - женский - Екатерина Петровна Кузнецова
Михаил Иванович Морозов - мужской - Александра Владимировна Морозова
Анна Дмитриевна Васильева - женский - Ольга Викторовна Васильева
Василий Павлович Ковалев - мужской - Наталья Сергеевна Ковалева
Алина Александровна Новикова - женский - Марина Игоревна Новикова
Илья Андреевич Соколов - мужской - Екатерина Петровна Соколова
Маргарита Дмитриевна Козлова - женский - Ирина Владимировна Козлова
Алексей Сергеевич Федоров - мужской - Елена Николаевна Федорова
Лидия Владимировна Иванова - женский - Мария Викторовна Иванова
Даниил Викторович Смирнов - мужской - Елена Сергеевна Смирнова
Софья Андреевна Петрова - женский - Ольга Анатольевна Петрова
Валерия Игоревна Кузнецова - женский - Марина Николаевна Кузнецова
Матвей Николаевич Морозов - мужской - Людмила Викторовна Морозова
Анастасия Владимировна Васильева - женский - Марина Андреевна Васильева
Артем Анатольевич Ковалев - мужской - Людмила Владимировна Ковалева
Ольга Игоревна Новикова - женский - Наталья Александровна Новикова
Владимир Сергеевич Соколов - мужской - Марина Анатольевна Соколова
Юлия Александровна Козлова - женский - Татьяна Сергеевна Козлова
Илья Васильевич Федоров - мужской - Ольга Петровна Федорова
Вероника Анатольевна Иванова - женский - Екатерина Николаевна Иванова
Антон Сергеевич Смирнов - мужской - Анна Владимировна Смирнова
Ольга Петровна Петрова - женский - Любовь Васильевна Петрова
Дмитрий Викторович Кузнецов - мужской - Татьяна Ивановна Кузнецова
Елена Анатольевна Морозова - женский - Ирина Владимировна Морозова
Иван Александрович Васильев - мужской - Наталья Сергеевна Васильева
Екатерина Викторовна Ковалева - женский - Тамара Петровна Ковалева
Павел Сергеевич Новиков - мужской - Ольга Ивановна Новикова
Марина Валерьевна Соколова - женский - Татьяна Анатольевна Соколова
Артемий Александрович Козлов - мужской - Екатерина Андреевна Козлова
Оксана Ильинична Федорова - женский - Елена Викторовна Федорова
Михаил Викторович Иванов - мужской - Александра Александровна Иванова
Анастасия Владимировна Смирнова - женский - Ольга Владимировна Смирнова
Вадим Андреевич Петров - мужской - Наталья Васильевна Петрова
Ирина Владимировна Кузнецова - женский - Татьяна Игоревна Кузнецова
Константин Николаевич Морозов - мужской - Евгения Сергеевна Морозова
Светлана Анатольевна Васильева - женский - Елена Владимировна Васильева
Андрей Викторович Ковалев - мужской - Ирина Андреевна Ковалева
Евгения Павловна Новикова - женский - Нина Валерьевна Новикова
Никита Андреевич Соколов - мужской - Татьяна Валерьевна Соколова
Алиса Александровна Козлова - женский - Екатерина Викторовна Козлова
Георгий Сергеевич Федоров - мужской - Наталья Александровна Федорова
Анастасия Александровна Иванова - женский - Мария Александровна Иванова
Денис Васильевич Смирнов - мужской - Ольга Николаевна Смирнова
Елена Игоревна Петрова - женский - Нина Владимировна Петрова
Антонина Александровна Кузнецова - женский - Татьяна Викторовна Кузнецова
Роман Викторович Морозов - мужской - Любовь Владимировна Морозова
Ирина Васильевна Васильева - женский - Екатерина Андреевна Васильева
Александр Владимирович Ковалев - мужской - Наталья Сергеевна Ковалева
Ольга Павловна Новикова - женский - Елена Николаевна Новикова
Сергей Игоревич Соколов - мужской - Марина Валерьевна Соколова
Маргарита Александровна Козлова - женский - Анна Петровна Козлова
Анатолий Владимирович Федоров - мужской - Валентина Владимировна Федорова
Вера Ивановна Иванова - женский - Галина Сергеевна Иванова
Игорь Викторович Смирнов - мужской - Людмила Николаевна Смирнова
Ольга Владимировна Петрова - женский - Ирина Николаевна Петрова
Владимир Андреевич Кузнецов - мужской - Лариса Викторовна Кузнецова
Марина Александровна Морозова - женский - Надежда Владимировна Морозова
Артем Васильевич Васильев - мужской - Ольга Сергеевна Васильева
Евгения Владимировна Ковалева - женский - Елена Александровна Ковалева
Артемий Павлович Новиков - мужской - Светлана Николаевна Новикова
Елизавета Николаевна Соколова - женский - Марина Ивановна Соколова
Виталий Владимирович Козлов - мужской - Елена Ивановна Козлова
Ирина Александровна Попова - женский - Анна Ивановна Попова