Алексей Александрович Белов - Алексей А.Б.
Анна Михайловна Соколова - Анна М.С.
Артём Дмитриевич Крылов - Артём Д.К.
Борис Александрович Иванов - Борис А.И.
Вадим Владимирович Кузнецов - Вадим В.К.
Валерия Викторовна Никитина - Валерия В.Н.
Василий Сергеевич Жуков - Василий С.Ж.
Вероника Игоревна Лебедева - Вероника И.Л.
Виктория Андреевна Ковалева - Виктория А.К.
Владимир Петрович Соловьёв - Владимир П.С.
Глеб Александрович Карпов - Глеб А.К.
Даниил Витальевич Максимов - Даниил В.М.
Дарья Александровна Комарова - Дарья А.К.
Денис Андреевич Литвинов - Денис А.Л.
Евгений Александрович Романов - Евгений А.Р.
Екатерина Васильевна Горбачёва - Екатерина В.Г.
Елизавета Анатольевна Кудряшова - Елизавета А.К.
Жанна Валерьевна Фёдорова - Жанна В.Ф.
Захар Михайлович Беляков - Захар М.Б.
Зинаида Александровна Никонова - Зинаида А.Н.
Иван Геннадьевич Поляков - Иван Г.П.
Ирина Сергеевна Богданова - Ирина С.Б.
Карина Николаевна Суворова - Карина Н.С.
Кирилл Игоревич Савельев - Кирилл И.С.
Константин Валерьевич Воробьёв - Константин В.В.
Лариса Николаевна Чернова - Лариса Н.Ч.
Леонид Андреевич Богданов - Леонид А.Б.
Лилия Александровна Полякова - Лиля А.П.
Максим Сергеевич Дмитриев - Максим С.Д.
Маргарита Васильевна Белоусова - Маргарита В.Б.
Марина Ивановна Макарова - Марина И.М.
Михаил Александрович Калинин - Михаил А.К.
Надежда Петровна Воронина - Надежда П.В.
Наталья Дмитриевна Медведева - Наталья Д.М.
Никита Александрович Зайцев - Никита А.З.
Оксана Андреевна Громова - Оксана А.Г.
Олег Игоревич Данилов - Олег И.Д.
Павел Владимирович Михайлов - Павел В.М.
Полина Анатольевна Киселева - Полина А.К.
Роман Александрович Тимофеев - Роман А.Т.
Руслан Валерьевич Шестаков - Руслан В.Ш.
Светлана Александровна Филиппова - Светлана А.Ф.
Сергей Павлович Никитин - Сергей П.Н.
Софья Андреевна Краснова - Софья А.К.
Татьяна Владимировна Сорокина - Татьяна В.С.
Тимур Александрович Беляев - Тимур А.Б.
Ульяна Михайловна Виноградова - Ульяна М.В.
Фёдор Дмитриевич Гусев - Фёдор Д.Г.
Христина Ивановна Симоненко - Христина И.С.
Цветана Сергеевна Нестерова - Цветана С.Н.
Чеслав Витальевич Ковалевский - Чеслав В.К.
Шарлотта Валерьевна Шестакова - Шарлотта В.Ш.
Эдуард Александрович Козлов - Эдуард А.К.
Юлия Павловна Федотова - Юлия П.Ф.
Ярослав Игоревич Савин - Ярослав И.С.
Агния Владимировна Богданова - Агния В.Б.
Александра Петровна Чернова - Александра П.Ч.
Алиса Андреевна Волкова - Алиса А.В.
Анатолий Иванович Горшков - Анатолий И.Г.
Ангелина Сергеевна Дорофеева - Ангелина С.Д.
Анна Павловна Захарова - Анна П.З.
Антон Владимирович Белов - Антон В.Б.
Арина Александровна Широкова - Арина А.Ш.
Борис Сергеевич Гришин - Борис С.Г.
Вадим Игоревич Чернов - Вадим И.Ч.
Валерия Дмитриевна Кузнецова - Валерия Д.К.
Варвара Александровна Белова - Варвара А.Б.
Василий Иванович Рыбаков - Василий И.Р.
Вера Андреевна Григорьева - Вера А.Г.
Виктор Владимирович Жуков - Виктор В.Ж.
Владислав Андреевич Попов - Владислав А.П.
Владислава Игоревна Коваленко - Владислава И.К.
Владлен Сергеевич Лебедев - Владлен С.Л.
Всеволод Александрович Шестаков - Всеволод А.Ш.
Галина Петровна Гребенщикова - Галина П.Г.
Глеб Александрович Горбачев - Глеб А.Г.
Даниил Сергеевич Лебедев - Даниил С.Л.
Дарья Андреевна Петрова - Дарья А.П.
Денис Иванович Степанов - Денис И.С.
Диана Александровна Соколова - Диана А.С.
Евгений Владимирович Ковалев - Евгений В.К.
Екатерина Игоревна Михайлова - Екатерина И.М.
Елена Андреевна Белова - Елена А.Б.
Елизавета Петровна Медведева - Елизавета П.М.
Жанна Сергеевна Васильева - Жанна С.В.
Захар Владимирович Новиков - Захар В.Н.
Зинаида Александровна Фадеева - Зинаида А.Ф.
Зоя Петровна Киселева - Зоя П.К.
Игнат Иванович Максимов - Игнат И.М.
Илья Александрович Крылов - Илья А.К.
Инна Павловна Соловьева - Инна П.С.
Карина Сергеевна Богданова - Карина С.Б.
Кирилл Игоревич Воробьев - Кирилл И.В.
Клавдия Александровна Белова - Клавдия А.Б.
Константин Владимирович Михайлов - Константин В.М.
Кристина Андреевна Кудрявцева - Кристина А.К.
Лариса Ивановна Гусева - Лариса И.Г.
Лев Сергеевич Тимофеев - Лев С.Т.
Леонид Игоревич Пономарев - Леонид И.П.
Лилия Александровна Сергеева - Лилия А.С.
Макар Сергеевич Журавлев - Макар С.Ж.
Маргарита Ивановна Николаева - Маргарита И.Н.
Марина Владимировна Борисова - Марина В.Б.
Марк Андреевич Соколов - Марк А.С.
Мария Игоревна Логинова - Мария И.Л.
Михаил Владимирович Ширяев - Михаил В.Ш.
Надежда Андреевна Васильева - Надежда А.В.
Наталья Петровна Соколова - Наталья П.С.
Никита Иванович Рыбаков - Никита И.Р.
Нина Сергеевна Баранова - Нина С.Б.
Оксана Александровна Лебедева - Оксана А.Л.
Олег Игоревич Жуков - Олег И.Ж.
Павел Андреевич Ковалев - Павел А.К.
Полина Ивановна Максимова - Полина И.М.
Роман Владимирович Поляков - Роман В.П.
Светлана Сергеевна Казакова - Светлана С.К.
Семен Александрович Белов - Семен А.Б.
Сергей Иванович Голубев - Сергей И.Г.
Татьяна Петровна Назарова - Татьяна П.Н.
Ульяна Игоревна Данилова - Ульяна И.Д.
