Александр Иванович Романов - Александр И.Р.
Екатерина Андреевна Петрова - Екатерина А.П.
Михаил Сергеевич Кузнецов - Михаил С.К.
Ольга Викторовна Смирнова - Ольга В.С.
Дмитрий Александрович Федоров - Дмитрий А.Ф.
Анна Степановна Иванова - Анна С.И.
Андрей Петрович Соколов - Андрей П.С.
Юлия Николаевна Васильева - Юлия Н.В.
Владимир Викторович Попов - Владимир В.П.
Светлана Александровна Ковалева - Светлана А.К.
Илья Валерьевич Морозов - Илья В.М.
Татьяна Дмитриевна Новикова - Татьяна Д.Н.
Георгий Николаевич Медведев - Георгий Н.М.
Мария Алексеевна Козлова - Мария А.К.
Петр Игоревич Сидоров - Петр И.С.
Надежда Сергеевна Белова - Надежда С.Б.
Константин Владимирович Лебедев - Константин В.Л.
Елена Викторовна Кузьмина - Елена В.К.
Сергей Александрович Тихонов - Сергей А.Т.
Анастасия Андреевна Михайлова - Анастасия А.М.
Игорь Валерьевич Николаев - Игорь В.Н.
Наталья Денисовна Зайцева - Наталья Д.З.
Алексей Сергеевич Казанцев - Алексей С.К.
Марина Геннадьевна Борисова - Марина Г.Б.
Василий Иванович Макаров - Василий И.М.
Евгения Олеговна Полякова - Евгения О.П.
Роман Александрович Дмитриев - Роман А.Д.
Людмила Андреевна Соколова - Людмила А.С.
Игорь Павлович Воробьев - Игорь П.В.
Оксана Михайловна Сергеева - Оксана М.С.
Алёна Викторовна Лебедева - Алёна В.Л.
Елена Сергеевна Тимофеева - Елена С.Т.
Ирина Владимировна Соловьёва - Ирина В.С.
Анастасия Александровна Федотова - Анастасия А.Ф.
Оксана Валерьевна Щербакова - Оксана В.Щ.
Тамара Ивановна Новикова - Тамара И.Н.
Нина Александровна Калинина - Нина А.К.
Ирина Викторовна Медведева - Ирина В.М.
Александра Дмитриевна Степанова - Александра Д.С.
Валентина Сергеевна Романова - Валентина С.Р.
Лариса Петровна Сидорова - Лариса П.С.
Ольга Валерьевна Васильева - Ольга В.В.
Татьяна Анатольевна Гусева - Татьяна А.Г.
Марина Владимировна Кузнецова - Марина В.К.
Людмила Николаевна Петрова - Людмила Н.П.
Виктория Валерьевна Попова - Виктория В.П.
Наталья Владимировна Ковалева - Наталья В.К.
Екатерина Алексеевна Белова - Екатерина А.Б.
Анастасия Ивановна Соколова - Анастасия И.С.
Светлана Андреевна Тихомирова - Светлана А.Т.
Надежда Петровна Иванова - Надежда П.И.
Инна Сергеевна Казакова - Инна С.К.
Оксана Владимировна Громова - Оксана В.Г.
Лидия Ивановна Трофимова - Лидия И.Т.
Алла Алексеевна Борисова - Алла А.Б.
Маргарита Сергеевна Кузьмина - Маргарита С.К.
Юлия Александровна Николаева - Юлия А.Н.
Елена Игоревна Дмитриева - Елена И.Д.
Софья Владимировна Калинина - Софья В.К.
Ирина Александровна Соколова - Ирина А.С.

teacher_of_subjects = {
    'Русский язык': ['Михаил С.К.', 'Екатерина А.П.', 'Дмитрий А.Ф.', 'Ольга В.С.', 'Александр И.Р.', 'Анна С.И.'],
    'Литература': ['Илья В.М.', 'Владимир В.П.', 'Светлана А.К.', 'Надежда С.Б.', 'Татьяна Д.Н.', 'Мария А.К.', 'Петр И.С.', 'Георгий Н.М.'],
    'Математика': ['Константин В.Л.', 'Сергей А.Т.', 'Алексей С.К.', 'Евгения О.П.', 'Игорь П.В.', 'Марина Г.Б.'],
    'Физика': ['Роман А.Д.', 'Людмила А.С.', 'Игорь В.Н.'],
    'Химия': ['Оксана М.С.', 'Елена С.Т.', 'Анастасия А.Ф.'],
    'Биология': ['Светлана А.К.', 'Андрей П.С.'],
    'Информатика': ['Анастасия А.М.', 'Алёна В.Л.', 'Игорь В.Н.'],
    'Иностранный язык': ['Юлия Н.В.', 'Елена В.К.'],
    'История': ['Елена В.К.', 'Наталья Д.З.'],
    'Обществознание': ['Наталья Д.З.', 'Анна С.И.'],
    'География': ['Василий И.М.', 'Марина Г.Б.'],
    'Физическая культура': ['Светлана А.К.', 'Юлия Н.В.'],
    'X': ["X"]
}